0001000000
0001000100
0001011100
0001000100
1011110101
0001000000
0001000000
0000000000
0001000000
0001000000
